0 1 6 20 16 17 2 3 1 1 16 17 6 20 1 1 2 3 1 1 6 20 2 3 1 1 1 1 6 20 0 0
0 1 13 27 23 24 2 3 1 1 23 24 13 27 1 1 2 3 1 1 13 27 2 3 1 1 1 1 13 27 0 0
7 8 16 17 1 1 2 3 11 12 6 20 1 1 1 1 2 3 6 20 1 1 2 3 11 12 6 20 1 1 0 0
14 15 23 24 1 1 2 3 9 10 13 27 1 1 1 1 2 3 13 27 1 1 2 3 9 10 13 27 1 1 0 0
21 22 1 1 6 20 2 3 16 17 1 1 18 19 18 19 2 3 16 17 1 1 2 3 16 17 18 19 1 1 0 0
0 0 1 1 13 27 0 0 0 0 1 1 0 0 0 0 0 0 23 24 1 1 0 0 0 0 0 0 1 1 0 0
0 1 1 1 9 10 2 3 0 0 1 1 1 1 0 0 0 1 18 19 11 12 0 0 16 17 11 12 1 1 0 0
0 1 1 1 0 0 2 3 0 0 1 1 1 1 0 0 0 1 0 0 9 10 0 0 23 24 9 10 25 0 0 0
0 1 6 20 16 17 2 3 0 0 1 1 6 20 0 0 0 1 1 1 16 17 0 0 1 1 4 5 2 3 0 0
0 1 13 27 23 24 2 3 0 0 1 1 13 27 0 0 0 1 1 1 0 0 0 0 1 1 5 1 2 3 0 0
0 1 11 12 1 1 2 3 0 0 1 1 1 1 0 0 0 1 1 1 1 1 1 1 4 5 1 1 2 3 0 0
0 1 9 10 1 1 2 3 0 0 1 1 1 1 0 0 0 1 1 1 1 1 1 1 5 1 1 1 2 3 0 0