0 0 0 0 1 2 45 45 24 25 45 45 48 49 3 4 0 0 0 0 0 0 0 0 0 0 0 0 0 0 0 0 0 0 0 0 0 0 0 0 0 0 0 0 5 6 43 56
0 0 12 13 14 1 45 45 36 37 45 45 48 49 15 16 12 13 12 13 12 13 12 13 45 45 45 45 12 13 45 45 12 13 12 13 45 45 12 13 45 45 12 13 17 19 43 56
0 0 13 26 45 45 1 2 45 45 45 45 48 49 27 28 13 26 5 6 7 8 13 26 24 25 5 6 7 8 3 4 13 26 5 6 7 8 24 25 5 6 7 8 38 50 43 56
0 0 14 13 45 45 14 1 45 45 45 45 48 49 39 40 14 13 17 19 19 20 14 13 36 37 17 19 19 20 15 16 14 13 17 19 19 20 36 37 17 19 19 20 51 52 43 56
0 0 45 45 45 45 45 45 1 2 24 25 48 49 13 26 24 25 19 19 19 19 24 25 13 26 31 19 41 53 27 28 45 45 31 19 19 19 13 26 19 19 19 19 13 26 43 56
0 0 45 45 45 45 45 45 14 1 36 37 48 49 14 13 36 37 18 29 30 53 36 37 14 13 43 19 42 42 39 40 45 45 43 19 32 19 14 13 18 29 30 53 14 13 43 56
0 0 24 25 45 45 0 0 0 0 0 0 48 49 38 50 13 26 38 50 41 53 13 26 24 25 55 19 42 42 13 26 45 45 55 19 55 19 24 25 19 19 42 42 45 45 0 0
0 0 36 37 45 45 12 13 12 13 12 13 48 49 51 52 14 13 51 52 42 42 14 13 36 37 54 19 42 42 14 13 45 45 54 19 54 19 36 37 18 29 42 42 45 45 45 9
0 0 0 0 45 45 24 25 45 45 13 26 48 49 13 26 24 25 42 0 13 26 45 45 45 45 0 0 13 26 24 25 45 45 13 26 13 26 13 26 13 26 45 45 45 45 19 21
0 0 12 13 45 45 36 37 45 45 14 13 48 49 14 13 36 37 12 13 14 13 45 45 45 45 12 13 14 13 36 37 45 45 14 13 14 13 14 13 14 13 45 45 45 45 19 33
0 0 45 45 0 0 0 0 45 45 45 45 48 49 45 45 45 45 45 45 45 45 45 45 45 45 45 45 45 45 45 45 45 45 45 45 45 45 45 45 45 45 0 0 0 0 0 0
0 0 45 45 12 13 12 13 0 0 0 0 0 0 0 0 0 0 0 0 0 0 0 0 0 0 0 0 0 0 0 0 0 0 0 0 0 0 0 0 0 0 0 0 0 0 0 0