0 1 2 3 1 1 1 1 4 5 11 12 2 3 0 0
0 1 2 3 1 1 1 1 5 2 9 10 2 3 0 0
0 1 2 3 1 1 4 5 1 1 16 17 2 3 0 0
0 1 2 3 1 1 5 1 1 1 23 24 2 3 0 0
0 0 2 3 4 5 9 10 18 19 1 1 2 3 0 0
0 0 0 0 0 0 0 0 0 0 1 1 2 3 0 0
0 0 2 3 16 17 1 1 1 1 1 1 2 3 26 26
0 0 2 3 23 24 1 1 1 1 25 0 0 0 0 0
7 8 2 3 1 1 1 1 4 5 1 1 11 12 0 0
14 15 2 3 1 1 1 1 5 1 1 1 9 10 0 0
21 22 2 3 9 10 4 5 18 19 18 19 9 10 0 0
0 0 0 0 0 0 0 0 0 0 0 0 0 0 0 0